99999999999999999999999999999999999999999999999-
99999999999999999999999999999999999999999999999-
99999999999999999999999999999999999999999999999-
99999999999999999999999999999999999999999999999-
99999999999999999999999999999999999999999999999-
99999999999999999999999999999999999999999999999-
99999999999999999999999999999999999999999999999-
99999999999999999999999999999999999999999999999-
99999999999999999999999999999999999999999999999-
99999999999990111111111111111111129999999999999-
99999999999904444444444444444444442999999999999-
99999999999044444444444444444444444299999999999-
99999999990444444444444444444444444429999999999-
99999999904444444444444444444444444442999999999-
99999999934444444444444444444444444445999999999-
99999999934444444444444444444444444445999999999-
99999999934444444444444444444444444445999999999-
99999999934444444444444444444444444445999999999-
99999999934444444444444444444444444445999999999-
99999999964444444444444444444444444448999999999-
99999999996444444444444444444444444489999999999-
99999999999644444444444444444444444899999999999-
99999999999964444444444444444444448999999999999-
99999999999996777777777777777777789999999999999-
99999999999999999999999999999999999999999999999-
99999999999999999999999999999999999999999999999-
99999999999999999999999999999999999999999999999-
99999999999999999999999999999999999999999999999-
99999999999999999999999999999999999999999999999-
99999999999999999999999999999999999999999999999-
99999999999999999999999999999999999999999999999-
99999999999999999999999999999999999999999999999-
99999999999999999999999999999999999999999999999