9999999999999999999999999999999-
9011111111111111111111111111129-
9344444444444444444444444444459-
9344444444444444444444444444459-
9344444444444444444444444444459-
9344444444444444444444444444459-
9344444444444444444444444444459-
9344444444444444444444444444459-
9344444444444444444444444444459-
9344444444444444444444444444459-
9344444444444444444444444444459-
9344444444444444444444444444459-
9344444444444444444444444444459-
9344444444444444444444444444459-
9344444444444444444444444444459-
9344444444444444444444444444459-
9677777777777777777777777777789-
9999999999999999999999999999999