999999999999999999999999999999999999999-
999999999999999999999999999999999999999-
999999999999999999999999999999999999999-
999999999999999999999999999999999999999-
999999999999999999999999999999999999999-
999990111111111111111111111111111299999-
999993444444444444444444444444444599999-
999993444444444444444444444444444599999-
999993444444444444444444444444444599999-
999993444444444444444444444444444599999-
999993444444444444444444444444444599999-
999993444444444444444444444444444599999-
999993444444444444444444444444444599999-
999993444444444444444444444444444599999-
999993444444444444444444444444444599999-
999993444444444444444444444444444599999-
999993444444444444444444444444444599999-
999993444444444444444444444444444599999-
999993444444444444444444444444444599999-
999993444444444444444444444444444599999-
999996777777777777777777777777777899999-
999999999999999999999999999999999999999-
999999999999999999999999999999999999999-
999999999999999999999999999999999999999-
999999999999999999999999999999999999999-
999999999999999999999999999999999999999